,,,,,,,,,,,,,,,,
,,,,,,,,,,,,,,,,
,,,,,,,,,,,,,,,,
,,,,,,,,,,,,,,,,
,,,,,,,,,,,,,,,,
,@,,,,,,,,,,,,,,
,,,,,,,,,,,,,,,,
....|..=..al.$..
................
................
................
60
1
