,,,,,,,,,,,,,,,,
,,,,,,,,,,,,,,,,
,,,,,,,,,,,,,,,,
,,,,,,,,,,,,,,,,
,,,,,,,,,,,,,,,,
,@,,,,,,,,,,,,,,
,,,,,,,,,,,,,,,,
....|..=..a.....
................
................
................