................
................
................
,,,,,,,,,,,=,,,,
,,,,,,,,,,,,,,,,
,,,,,,,,,,,|,,,,
,@,,,,,,,,,,,,,,
,,,,,,,,,,,a,,,,
,,,,,,,,,,,l,,,,
................
................
180
2