,,,,,,,,,,,,,,,,
,,,,,,,,,,,,,,,,
,,,,,,,,,,,,,,,,
,,,,,,,,,,,,,,,,
,,,,,,,,,,,,,,,,
,@,,,,,,,,,,,,,,
,,,,,,,,,,,,,,,,
....|..=..al....
................
................
................
60
2